0 0 1 0 2 0 3 0 0 0 0 0 0 0 0 0 1 4 0 4 0 4 0 4 0 4 0 4 0 4 1 4 6 3 0 4 1 4 0 4
0 0 1 1 2 1 3 1 0 0 0 0 0 0 0 0 1 4 0 4 0 4 0 4 0 4 0 4 0 4 1 4 6 3 0 4 1 4 0 4
0 0 1 2 2 2 3 2 0 0 0 0 0 0 6 0 1 4 0 4 0 4 0 4 0 4 0 4 0 4 1 4 6 3 0 4 1 4 0 4
0 0 0 0 0 0 0 0 0 0 4 3 4 2 6 1 1 4 0 4 0 4 0 4 0 4 0 4 0 4 1 4 6 3 0 4 1 4 0 4
0 3 1 3 1 3 1 3 2 3 4 3 4 3 6 2 1 4 0 4 0 4 0 4 0 4 0 4 0 4 1 4 6 3 0 4 1 4 0 4
0 4 0 4 0 4 0 4 0 4 1 4 6 3 4 0 5 0 0 4 0 4 0 4 0 4 0 4 0 4 1 4 6 3 0 4 1 4 0 4
0 4 0 4 0 4 0 4 0 4 1 4 6 3 4 1 5 1 0 4 0 4 0 4 0 4 0 4 0 4 1 4 6 3 0 4 1 4 0 4
0 4 0 4 0 4 0 4 0 4 1 4 6 3 0 4 1 4 0 4 0 4 0 4 0 4 0 4 0 4 1 4 6 3 0 4 1 4 0 4
0 4 0 4 0 4 0 4 0 4 1 4 6 3 0 4 1 4 0 4 0 4 0 4 0 4 0 4 0 4 1 4 6 3 0 4 1 4 0 4
0 4 0 4 0 4 0 4 0 4 1 4 6 3 0 4 1 4 0 4 0 4 0 4 0 4 0 4 0 4 1 4 6 3 0 4 1 4 0 4
0 4 0 4 0 4 0 4 0 4 1 4 6 3 0 4 1 4 0 4 0 4 0 4 0 4 0 4 0 4 1 4 6 3 0 4 1 4 0 4
0 4 0 4 0 4 0 4 0 4 1 4 6 3 0 4 1 4 0 4 0 4 0 4 0 4 0 4 0 4 1 4 6 3 0 4 1 4 0 4